Bernard Cazeneuve: bcv, bdce
aboutissant: abtçè, abùtè
absorbant: absrbè, absrè
mondialisation: mdlzn, mhdlzn
systématisme: sstmtsm, sstmtm
Washington: wàgth, wàgtn
partenariat: prtnra, prtnria
achevant: aàvè, aàè
acquittant: aqè, aqtè
adaptant: adpè, adtè
américain: amrcé, amré
adoptant: adtè, adpè, adptè
acceptant: axptè, axpè
accompagnant: acpnè, acpyè
accordant: acrdè, acrè
accréditant: acrdtè, acrdè
accroissant: acrtè, acrçè
allemand: almè, alm
affaiblissant: afblè, afblçè
affermissant: afrmè, afrmçè
affrontant: afrtè, afrhè
aveugle: avg, avglri, avglrj, avglrsi
aggravant: agrvè, agrè
agissant: agè, agçè
agitant: agtè, agè
ahurissant: aurçè, aurè
bissextile: bçxtly, bsxtl
ajoutant: ajtè, ajè
ajustant: ajstè, ajsè
allant: éè, alè
allongeant: alè, algè
brutal: brl, brtl
améliorant: amlrè, amlè
amorçant: amrè, amrcè
chaotique: chtq, caotq
annonçant: ancè, anhè, ançè
anticipant: ètcpè, ètcè
cohérent: corè, crè, chrè
compréhensible: cprsb, cprhsb
appréciant: aprcè, aprciè
appréhendant: aprèè, aprè, aprdè
apprenant: aprdè, aprnè
conclues: ccluw, cclrst
appropriant: aprprè, aprpè
approuvant: aprvè, aprè
conforme: cfrm, cfrmri, cfrmrj, cfrmrsj, cfrmrsi
contracte: ctrctri, ctrctrj, ctrctrsj, ctrctrsi
arrangeant: argè, arèè
convergent: cvrgè, cvrgrp, cvrgrsp
corporatiste: crprtt, crprtst
corporel: crprl, cprl
assistant: açsè, açstè, açtè
coïncident: ccdrp, ccdrsp
critique: crtq, crtqri, crtqrj, crtqrsj, crtqrsi
assourdissant: açrdçè, açrdè
attardant: atrdè, atrè
célèbre: clbrri, clbrrj, clbrrsi
augmentant: ogmtè, ogmè
augurant: ogè, ogrè
dissuasif: dçzf, dszf
divergent: dvrgrp, dvrgrsp, dvrgè
avançant: avcè, avè
domestique: dmstq, dmstqri, dmstqrj, dmstqrsj, dmstqrsi
double: dùb, dbl, db
douce: dùç, dxy
décuple: dcplri, dcplrj, dcplrsj, dcplrsi
dégoûtant: dfntè, dgtè
dégoûté: dfnté, dgté
démagogique: dmggq, dmgq
emphatique: èftq, èptq
ennuyeux: enyx, ènyx
erratique: ertq, rtq
exceptionnel: xcptnl, xcpnl
exhaustif: xstf, exstf
explicite: xplct, xplctri, xplctrj, xplctrsj, xplctrsi, xplcri, xplcrj, xplcrsj, xplcrsi
expédient: xpdrp, xpdrsp
extraordinaire: xtrdna, xtrrdna
extrémiste: xtrmt, xtrmst
exécutif: xctf, exctf
facultatif: fcltf, fclttf
farouche: frà, frùà
fixe: fxrj, fxrsj, fxrsi, fxri
fondamental: fdmtl, fdml
fréquent: frqè, frqé
gauche: goà, gà
grave: grvri, grvrj, grvrsj, grvrsi, grv
général: gal, gnrl
homologue: omlg, omlgri, omlgrj, omlgrsj, omlgrsi
illustre: ilstrri, ilstrrj, ilstrrsi, ilstri, ilstrj, ilstrsj, ilstrsi
immédiat: imda, imdia
imparfait: éprfé, éprfè
impossible: épçb, ipçb
inadapté: indt, indpt
indigne: édyri, édyrj, édyrsj, édyrsi
indispensable: édspsb, édspb
cantonnant: ctnè, cètnè
informe: éfrmri, éfrmrj, éfrmrsj, éfrmrsi
inintéressant: éntrçè, éétrçè
institutionnel: éstttnl, ésttnl
insurrectionnel: ésrctnl, ézrctnl
interdépartemental: étrdprmtl, étrdprtmtl
international: étrntnl, étrntl
intègre: étgrri, étgrrj, étgrrsj, étgrrsi
inutile: intl, intly
invalide: évld, évldri, évldrj, évldrsj, évldrsi
inverse: évrs, évrsri, évrsrj, évrsrsi
invraisemblable: évrsbb, évrsblb
libre: lb, lbr
limitatif: lmtf, lmttf
liquide: lqd, lqri, lqrj, lqrsj, lqrsi
lâche: làri, làrj, làrsi
magnifique: mnfq, myfq
manichéen: mnicé, mncén
manifeste: mnfstri, mnfstrj, mnfstrsj, mnfstrsi, mnfsri, mnfsrj, mnfsrsj, mnfsrsi
mathématique: mtmtq, mtmq
merveilleux: mrvyx, mrvx
ménager: mnr, mngr
nombreux: nbrx, nbx
nominatif: nmtf, nmntf
néerlandais: nrldé, nrld
négligent: nglgrp, nglgrsp, nglrp, nglrsp
occulte: oclri, oclrj, oclrsj, oclrsi
choisissant: àzè, àzçè
performant: prfrmè, prfmè
performatif: prfrmtf, prfmtf
pessimiste: pçmst, pçmt
porte: prri, prrj, prrsj, prrsi, prtri, prtrj, prtrsj, prtrsi
pratique: prtqri, prtqrj, prtqrsj, prtqrsi, prtq
premier: prmé, pmré
problématique: prblmtq, pblmtq
proche: prà, proà
prodigue: prdgri, prdgrj, prdgrsj, prdgrsi, prdg
progressiste: prgrçt, prgrçst
prolifère: prlfrri, prlfrrj, prlfrrsj, prlfrrsi
propre: prpr, prp
prospère: prspri, prsprj, prsprsj, prsprsi, prsprri, prsprrj, prsprrsi
préjudiciel: prdcl, prjdcl
prévalent: prvlrp, prvlrsp
public: pblc, plbc
puissant: pwçè, pçè
collectant: clctè, clcè
quantitatif: qttf, qtttf
quintuple: qtplri, qtplrj, qtplrsj, qtplrsi
quitte: qtri, qtrj, qtrsj, qtrsi
relaxe: rlxri, rlxrj, rlxrsi, rlx
complétant: cpltè, cplè
représentatif: rprzttf, rprztf
ressortissant: rsrtçè, rçrtçè
concentrant: cctrè, cctè
concluant: cclè, chclè
condamnant: chdnè, cdnè
conduisant: cdwè, cdzè
récapitulatif: rcptltf, rcptlf
configurant: cfgè, cfgrè
connaissant: cntè, cnçè
résident: rzdrp, rzdrsp, rzdè
résilient: rzlrp, rzlrsp, rzlè
rétrograde: rtrgrdri, rtrgrdrj, rtrgrdrsj, rtrgrdrsi
connectant: cnctè, cncè
conservant: csrvè, chsrvè
constatant: cstè, csttè
consultant: cslè, csltè
contactant: ctctè, ctcè
semblable: sbb, sblb
semestriel: smstrl, smtrl
contentant: ctnè, chttè, cttè
contestant: ctstè, ctsè
continuant: ctnè, chtnè
contraignant: ctrnè, ctrdè, ctryè
sophistique: sfstqri, sfstqrj, sfstqrsj
souhaitable: sùtb, shtb
spectaculaire: spctcla, spctla
splendide: spldd, spld
spécialiste: spclst, spclt
statistique: ststq, sttstq
substantiel: sbstl, sbsttl
susceptible: scptb, ssptb
suspect: spct, ssp, sspct
sympathique: sptq, séptq
sémantique: smètq, smtq
terrestre: trstr, trst
théorique: torq, trq
correspondant: crspdè, crdè
corrigeant: crè, crgè
transporteur: trsprtu, trsptu
transposable: trspzb, trpzb
tripartite: trprtt, trprt
trouble: trblri, trblrj, trblrsj, trblrsi, trb
courant: crè, cùrè
urbain: ubé, urbé
valide: vlri, vlrj, vlrsj, vlrsi, vldri, vldrj, vldrsi
violent: vlrp, vlrsp
vraisemblable: vrsblb, vrsbb
croyant: crè, èè, cryè
émergent: émrgrp, émrgrsp
énergique: énrgq, nrgq
énergétique: nrgtq, énrgtq
étrange: étrgri, étrgrj, étrgrsi, étrg
abaisse: abçri, abçrj, abçrsj, abçrsi
agression: agrn, agrçn
ajoute: ajtrj, ajtri, ajtrsj, ajtrsi, ajri, ajrj, ajrsj, ajrsi
acceptation: axptn, axpn
accès: axc, axck
accroche: acràrj, acràri, acràrsj, acràrsi
accueil: acl, accueil
adjudicataire: adjdcta, adjcta
administrateur: admstrtu, admnstrtu
administration: admn, admntn
administratrice: admstrtuy, admnstrtuy
adoption: adpn, adtn
adresse: adrçri, adrçrj, adrçrsj, adrçrsi, adrs
adverbe: advrb, advb
affiche: afàri, afàrj, afàrsj, afàrsi, afà
afflux: aflx, aflxk
alchimie: alàmi, alcmi
alcool: acl, alcl
allège: algrsi, algri, algrj
allonge: alri, alrj, alrsj, alrsi, algri, algrj, algrsj, algrsi
ambition: èbtn, èbn
amende: amd, amdri, amdrj, amdrsi
amorce: amrri, amrrj, amrrsi
amour: amùr, amù
argument: argm, argum
analyse: anlzri, anlzrj, anlzrsj, anlzrsi, anlz
anglicisme: èglm, èglcsm
angoisse: ègçri, ègçrj, ègçrsj, ègçrsi, ègç
annonce: anhç, ancri, ancrj, ancrsj, ancrsi, anç, anhri, anhrj, anhrsj, anhrsi, ançri, ançrj, ançrsj, ançrsi
arrangement: arègm, argm
applique: aplqri, aplqrj, aplqrsj, aplqrsi
appréhension: aprén, aprèn
approche: aprà, apràri, apràrj, apràrsj, apràrsi
appropriation: aprprn, apprn
aptitude: apttd, aptd
arbitre: arbtrri, arbtrrj, arbtrrsj, arbtrrsi
architecture: aràtctu, aàrtctu
attache: atà, atàri, atàrj, atàrsj, atàrsi
attaque: atqri, atqrj, atqrsj, atqrsi, atq
attelle: atlri, atlrj, atlrsj, atlrsi
attentat: attta, atta
attention: atn, atèn
attrape: atrpri, atrprj, atrprsi
aucunement: acnm, ocnm
augure: ogri, ogrj, ogrsj, ogrsi, ogrri, ogrrj, ogrrsi
authentification: ottfcn, otfcn
autobus: otbs, otbsk
automne: otmn, otn
automobiliste: otmblt, otmblst, atmblst
autour: otùr, otù
autre: otr, ot
avance: avç, avcri, avcrj, avcrsj, avcrsi, avri, avrj, avrsj, avrsi
aventure: avtu, avtrri, avtrrj, avtrrsj, avtrrsi
baisse: bçri, bçrj, bçrsj, bçrsi, bs
balade: bldri, bldrj, bldrsi
balance: blri, blrj, blrsj, blrsi, blç
bascule: bsclri, bsclrj, bsclrsi
base: bz, bzri, bzrj, bzrsj, bzrsi
bataille: btyri, btyrj, btyrsj, btyrsi, bty
batte: btrsj, btrsi
bouche: bàri, bàrj, bàrsj, bàrsi, bùà
boucle: bclri, bclrj, bclrsi, bùc
bouge: bgri, bgrj, bgrsi
bouille: bùyrsj, bùyrsi
bâtiment: batm, btm
brasse: brçri, brçrj, brçrsi
bride: brri, brrj, brrsi
brigue: brgri, brgrj, brgrsi
business: bzns, bznsk
cache: càri, càrj, càrsi
calibre: clbrri, clbrrj, clbrrsi
capitule: cptlri, cptlrj, cptlrsj, cptlrsi
capture: cptrri, cptrrj, cptrrsi
carbure: crbrri, crbrrj, crbrrsi
carène: crnri, crnrj, crnrsi
cartographie: crtgrfi, ctrgrfi
casse: cçri, cçrj, cçrsj, cçrsi
catalyse: ctlzri, ctlzrj, ctlzrsj, ctlzrsi
catastrophe: ctstrf, ctstrfri, ctstrfrj, ctstrfrsj
cause: coz, czri, czrj, czrsi
cesse: cçri, cçrj, cçrsj, cçrsi, cs
change: àgri, àgrj, àgrsj, àgrsi
chaos: cao, caok
charge: àrg, àrri, àrrj, àrrsj, àrrsi
chasse: àçri, àçrj, àçrsj, àçrsi
chauffage: àfag, àfg
chauffe: àfri, àfrj, àfrsj, àfrsi
cherche: àràri, àràrj, àràrsj, àràrsi
cheville: àvyri, àvyrj, àvyrsj, àvyrsi
chiffre: àfr, àfrri, àfrrj, àfrrsj, àfrrsi
choix: àx, àxk
choucroute: àùcrt, àcrùt
cible: cblri, cblrj, cblrsj, cblrsi
classe: clçri, clçrj, clçrsi, clç, cls
clique: clqri, clqrj, clqrsi
clôture: cltrri, cltrrj, cltrrsi
cohésion: chzn, cézn
collaborateur: clbrtu, clbrtuy
collapsus: clps, clpsk
collecte: clctri, clctrj, clctrsj, clctrsi, clct, clcri, clcrj, clcrsj, clcrsi
combinaison: cbnzh, cbnzn
combine: cbnri, cbnrj, cbnrsj, cbnrsi
commande: cmdri, cmdrj, cmd, cmdrsj, cmdrsi
commerce: cmrçri, cmrçrj, cmrçrsj, cmrçrsi, cmrç
communication: cmncn, cmcn
compétition: cptn, chptn
complétions: cpltrin, cpltrsn, cplrin, cplrsn
comporte: cprtri, cprtrj, cprtrsj, cprtrsi, cprtrsi, cprtrsi
compréhension: cprèn, cprn
comptage: chtg, cptg, ctg
compte: cpt, cht, cptrj, cptri, cptrsi
concentration: cctrn, ccrtn
concession: ccn, cçn, ccçn
concours: ccù, ccùk, ccrrj, ccrrt
condamnation: cdnn, cdmn
confesse: cfçri, cfçrj, cfçrsj, cfçrsi
conseil: cl, csl
consensus: csss, csssk
conserve: csrvri, csrvrj, csrvrsj, csrvrsi, chsrvri, chsrvrj, chsrvrsi
consultation: csltn, cslttn
consulte: cslrsj, cslrsi, cslri, cslrj, csltri, csltrj, csltrsj, csltrsi
conteste: ctstri, ctstrj, ctstrsj, ctstrsi, ctsri, ctsrj, ctsrsj, ctsrsi
contraste: ctrsri, ctrsrj, ctrsrsj, ctrsrsi
contrecarre: ctrcrri, ctrcrrj, ctrcrrsj
contrôle: ctrl, ctrlrj, ctrlrsj, ctrlrsi, ctrlri, chtrl
controverse: ctrvrsri, ctrvrsrj, ctrvrsrsj, ctrvrs
convention: cn, cvn
conviction: cvcn, cvicn
convocation: cvcn, chvcn
coordination: crdnn, crdn
corpus: crps, crpsk
corridor: crdr, crdo
couche: cùàri, cùàrj, cùàrsj, cùàrsi, cùà
courrier: cré, cùré
cours: cùrk, crrt, crrj, cù, cùk
cylindre: cldrri, cldrrj, cldrrsj, cldrrsi
débat: dba, dbtri
débrouille: dbryri, dbryrj, dbryrsj, dbryrsi
décharge: dàrgri, dàrgrj, dàrgrsj, dàrgrsi
déchéance: dàç, déàç
déclenche: dclàri, dclàrj, dclàrsj, dclàrsi
découpe: dcùpri, dcùprj, dcùprsi
dedans: ddè, ddèk
défends: dfdrj, dfdrt
défroque: dfrqri, dfrqrj, dfrqrsj, dfrqrsi
délégation: dgn, dlgn
délivre: dlvrrsi, dlvrri, dlvrrj
demande: dmdri, dmdrj, dmdrsj, dmdrsi, dmd, dmrsj, dmrsi, dmri, dmrj
commandement: cmèdm, cmdm
démarche: dmrà, dmràri, dmràrj, dmràrsj, dmràrsi
demeure: dmrri, dmrrj, dmrrsj, dmrrsi
démontage: dmtg, dmgt
dénomination: dnmnn, dnmn
dépêche: dpàri, dpàrj, dpàrsj, dpàrsi, dpà
complément: cplmè, cplm
dépense: dpsri, dpsrj, dpsrsj, dpsrsi
dépose: dpzri, dpzrj, dpzrsj, dpzrsi
dérive: drvri, drvrj, drvrsi, drv
déroute: drctri, drctrj, drctrsi, drtri, drtrj, drtrsj, drtrsi
déséquilibre: dzqlb, dzqlbrri, dzqlbrrj
dessert: dsrvri, dçrvri
dessous: dçù, dçùk
dessus: dçu, dçuk
destination: dstnn, dstn
détection: dtctn, dtcn, dttcn
détention: dtn, dttn
détermination: dtrmnn, dtrmn
devise: dvz, dvzri, dvzrj, dvzrsi
devoir: dvr, x
absolument: abslm, abm
dimension: dmnn, dmèn, dmn
discipline: dcpln, dcplnri, dcplnrj, dcplnrsj, dcplnrsi, dspln
discours: dscù, dscùk
discrimination: dscrmnn, dscrmn
dispense: dspsri, dspsrj, dspsrsj, dspsrsi
disposition: dspzn, dpzn, dpn
dispute: dspt, dsptri, dsptrj, dsptrsi
distance: dstç, dstcri, dstcrj, dstcrsj, dstcrsi
doit: dvri, xi
donne: dnri, dnrj, dnrsj, dnrsi
duplique: dplqri, dplqrj, dplqrsj, dplqrsi
dynamisme: dnmm, dnmsm
échange: éàg, éàri, éàrj, éàrsj, éàrsi, éàgri, éàgrj, éàgrsj, éàgrsi
échéance: éàç, éàèç
acheminement: aàmn, aàmnm
éclaire: éclrri, éclrrj, éclrrsi
écoute: éctri, éctrj, éctrsj, éctrsi, éctrsi, éct
administrativement: admnstrtvm, admnstrvm
effectivité: efct, efctvt
efficacité: efct, efcct
effiloche: eflàri, eflàrj, eflàrsj, eflàrsi
effraie: efrri, efrrj, efrrsj, efrrsi, efryri, efryrj, efryrsi
élève: élri, élrj, élrsj, élrsi, élv
embauche: èbàri, èbàrj, èbàrsj, èbàrsi, èboà
embouteillage: èbtg, èbtyg
embrasse: èbrçrj, èbrçri, èbrçrsj, èbrçrsi
empire: èpr, èprri, èprrj, èprrsi
constitutionnellement: cstttnlm, csttnlm
encaisse: ècçri, ècçrj, ècçrsj, ècçrsi
enclave: èclri, èclrj, èclrsj, èclrsi
encombre: ècbrri, ècbrrj, ècbrrsj, ècbrrsi, ècb
endosses: èdçrst, èdçrt
énergie: nrj, énrj
enquête: èqt, èqtri, èqtrj, èqtrsj, èqtrsi
enseigne: èsnri, èsnrj, èsnrsj, èsnrsi, èsyri, èsyrj, èsyrsj, èsyrsi
entame: ètmri, ètmrj, ètmrsj, ètmrsi
enthousiasme: ètzsmri, ètzsmrj, ètzsm
entrait: ètrrii, ètrii
entrave: ètrvrsi, ètrvri, ètrvrj, ètrvrsj, ètrvrsi, ètrv
entrepreneur: ètrpnu, ètrprnu
enveloppe: èvlp, èvlpri, èvlprj, èvlprsj, èvlprsi
envers: èvr, èvrk
envie: èvi, èvri, èvrj, èvrsi
épargne: épyrj, épyri, épyrsj, épyrsi, épryri, épryrj
épaule: éplri, éplrj, éplrsi
éponge: épg, épgrsi, épgri, épgrj
équilibre: éqlbrri, éqlbrrj, éqlbrrsj, éqlbrrsi, éqlb
équipe: éqp, éqpri, éqprj, éqprsi, éqri, éqrj, éqrsj, éqrsi
escalade: scldri, scldrj, scldrsj, scldrsi, scld, sclri, sclrj, sclrsj, sclrsi
esclavagisme: sclvgsm, sclvgm
escompte: sctri, sctrj, sctrsj, sctrsi, scpri, scprj, scprsj, scprsi
essai: eçé, éc
essor: eço, eçr
estime: stmri, stmrj, stmrsj, stmrsi
estompe: stpri, stprj, stprsj, stprsi, stri, strj, strsj, strsi
étoffe: étfri, étfrj, étfrsi
euphémisme: efmsm, efmm
évaluation: évln, évaln
examen: xmé, exmé
excès: xc, xck
excuse: xcz, xczri, xczrj, xczrsi
exemption: xpn, xptn
exequatur: xqtu, xqtuk
expectative: xpctv, xpcttv
expertise: xprtz, xprtzri, xprtzrj, xprtzrsj, xprtzrsi
explication: xplcn, xplctn
expression: xprn, xprçn
expulsion: xpln, xplsn
extension: xtn, xtsn
fabrique: fbrqri, fbrqrj, fbrqrsj, fbrqrsi, fbrq
facture: fctu, fctrri, fctrrj, fctrrsi
fantasme: ftsmri, ftsmrj, ftsmrsj, ftsmrsi, ftsm, fntsm
fascine: fsnri, fsnrj, fsnrsj, fsnrsi
ferment: frmrp, frmrsp
figure: fgrri, fgrrj, fgrrsj, fgrrsi, fgri, fgrj, fgrsj, fgrsi
file: flri, flrj, flrsj, flrsi
finance: fncri, fncrj, fncrsj, fncrsi, fnri, fnrj, fnrsj, fnrsi, fnç
flèche: flàri, flàrj, flàrsj, flàrsi
flotte: fltri, fltrj, fltrsi
flux: flx, flxk
fonction: fhcn, fcn
fondation: fhdn, fdn
fonds: fhk, fdrj, fdrt
forme: frm, frmri, frmrj, frmrsj, frmrsi
croisement: crzm, crwzm
formule: frmlri, frmlrj, frmlrsj, frmlrsi, frml
démocratiquement: dmcrtqm, dmctqm
frappe: frp, frprj, frpri, frprsi, frri, frrj, frrsj, frrsi
gâche: gàri, gàrj, gàrsi
galope: glpri, glprj, glprsi
garde: grd, grdri, grrsi, grri, grrj
déploiement: dplm, dplwm
gêne: gnri, gnrj, gnrsj, gnrsi
gens: gèk, gè
glisse: glçri, glçrj, glçrsi
gouverne: gvrnri, gvrnrj, gvrnrsj, gvrnrsi
déroulement: drlm, drml
gratitude: grtd, grttd
gros: gro, grok
guette: gtrj, gtri, gtrsj, gtrsi
guide: gdri, gdrj, gdrsi
habilitation: abltn, abtn
harmonisation: armnzn, armzn
hausse: oç, oçri, oçrj, oçrsj, oçrsi
héberge: ébrri, ébrrj, ébrrsj, ébrrsi, ébrgri, ébrgrj, ébrgrsi
hiatus: its, itsk
hiérarchie: irrài, irài
hiérarchisation: irràzn, iràzn
hypothèque: iptq, iptqri, iptqrj, iptqrsj, iptqrsi
immobilisme: imblm, imblsm
inadéquation: indqn, édqn
incertitude: écrtd, écrttd
incitation: écttn, éctn
incohérence: échrç, écrç
incompréhension: écprn, écprèn
incrimination: écrmnn, écrmn
influence: éflç, éflcri, éflcrj, éflcrsj, éflcrsi
insertion: ésrn, ésrtn
instantanéité: éstnt, ésttnt
insulte: ésltri, ésltrj, ésltrsi
intention: étn, étèn
interlocuteur: étrctu, étrlctu
interlocutrice: étrctuy, étrlctuy
interprétation: étrptn, étrprtn
interprète: étrprtri, étrprtrj, étrprtrsj, étrprtrsi, étrpt, étrprt
invitation: évtn, évttn
invite: évtri, évtrj, évtrsi
dévouement: dvm, dvùm
joue: jùri, jùrj, jùrsj, jùrsi, jri, jrj, jrsi
jour: jùr, jù
juge: jg, jri, jrj, jrsi
juridiction: jdn, jrdcn
kilomètre: klmt, km
laisse: lçri, lçrj, lçrsj, lçrsi
lance: lcri, lcrj, lcrsi
lancer: lècr, lcr
lève: lri, lrj, lrsi
lever: lr, lvr
lézarde: lzrdri, lzrdrj, lzrdrsi
liaison: lzh, lzn
libelle: lblri, lblrj, lblrsj, lblrsi
ligne: ly, lyri, lyrj, lyrsi
limite: lmtri, lmtrj, lmtrsj, lmtrsi, lmri, lmrj, lmrsj, lmrsi, lmt
lise: lrsj, lrsi
lis: lrj, lrt
longueur: lhgu, lgu
lutte: ltri, ltrj, ltrsj, ltrsi
magistrature: mgstrtu, mgtu, mgau
maintien: mété, mté
maîtrise: mtrzri, mtrzrj, mtrzrsj, mtrzrsi
manger: mègr, mgr
manipule: mnplri, mnplrj, mnplrsj, mnplrsi
manque: mqri, mqrj, mqrsj, mqrsi, mèq
marche: mrà, mràri, mràrj, mràrsj, mràrsi
marque: mrqri, mrqrj, mrqrsj, mrqrsi, mrq
masque: msqri, msqrj, msqrsi
massacre: mçc, mçcrri, mçcrrj, mçcrrsj, mçcrrsi
matricule: mtcltri, mtcltrj, mtcltrsj, mtcltrsi
mauvais: mvé, mvék
mécanisme: mcnsm, mcnm
mèche: màri, màrj, màrsi
méconnaissance: mnçç, mcnçç
mélange: mlgri, mlgrj, mlgrsj, mlgrsi
membre: mb, mèb
menace: mnç, mnri, mnrj, mnrsj, mnrsi, mnçri, mnçrj, mnçrsi, mncri, mncrj, mncrsi
ménage: mnri, mnrj, mnrsj, mnrsi, mngri, mngrj, mngrsi
mention: mètn, mèn
mérite: mrri, mrrj, mrrsj, mrrsi, mrtrj, mrtrsi, mrtri
mésestime: mzstmri, mzstmrj, mzstmrsj, mzstmrsi
mesure: mzrri, mzrrj, mzrrsi, mzu
mets: mtrj, mtrt
module: mdl, mdlri, mdlrj, mdlrsi
monnaie: mnyri, mnyrj, mnyrsj, mnyrsi
monte: mhtri, mhtrj, mhtrsj, mhtrsi
montre: mtrri, mtrrj, mtrrsj, mtrrsi
muse: mri, mrj, mrsi
naufrage: nfrri, nfrrj, nfrrsj, nfrrsi
négociation: négo, ngcn
nombre: nbr, nhb
nomination: nmnn, nmn
objet: obj, obg
obsèques: obsqs, obsqk
observation: obsrvn, obs
obsolescence: oblcç, obslcç
offense: ofsri, ofsrj, ofsrsj, ofsrsi
officier: ofcé, ofcr
offre: ofrri, ofrrj, ofrrsj, ofrrsi, ofr
opinion: opnn, opn
optimisme: optmm, optmsm
orchestre: orcst, orctrri, orctrrj, orctrrsj, orctrrsi
ordre: od, ord
organisation: ognzn, ogn
orthographie: ortgrfri, ortgrfrj
oublie: ùblri, ùblrj, ùblrsj, ùblrsi
paix: pé, pék
dysfonctionnement: dsfcnm, dsfctnm
parade: prdri, prdrj, prdrsi
parafe: prfri, prfrj, prfrsi
paramètre: prmtrri, prmtrrj, prmtrrsj, prmtrrsi, prmt
parcours: prcrrj, prcrrt
partage: prtgrsj, prtgrsi, prtgri, prtgrj, prtg
participe: prtcri, prtcrj, prtcrsj, prtcrsi, prtcp, prtcpri, prtcprj, prtcprsj, prtcprsi
particularisme: prtclrsm, prtclrm
pas: o, ok
passe: pçri, pçrj, pçrsj, pçrsi
pâtis: ptrj, ptrt, ptik
patrouille: ptry, ptryri, ptryrj, ptryrsj, ptryrsi
pêche: pàri, pàrj, pàrsj, pàrsi
pédale: pdl, pdlri, pdlrj, pdlrsi
penser: pèsr, psr
perquisition: prqzn, pqn
phagocyte: fgcri, fgcrj, fgcrsj, fgcrsi
pharmacien: frmcéy, frmcé
phase: faz, fz
photographie: ftgrfi, ftgrfri, ftgrfrj
photo: foto, fto
pilote: plt, pltri, pltrj, pltrsi
pique: pqri, pqrj, pqrsj, pqrsi
place: plç, plri, plrj, plrsj, plrsi
placer: plr, plcr
porter: prr, prtr
pose: pzri, pzrj, pzrsj, pzrsi
poursuite: prst, prswt
pousse: pùçri, pùçrj, pùçrsj, pùçrsi
pragmatisme: prgmtsm, prgmtm
praticienne: abtstay, erpnzny, crçriy, prtcéy
praticiens: abtstak, erpnznk, crçrik, prtcék
préoccupation: prcpn, pcpn
prérogative: prrgtv, prgtv
préside: przri, przrj, przrsj, przrsi, przdri, przdrj, przdrsi
président: przrp, przrsp, przdrp, przdrsp, przdè, pdt, psdt
presse: prçri, prçrj, prçrsi, prs
prétexte: prtxt, prtxtri, prtxtrj, prtxtrsi
printemps: prtè, prtèk, prétè, prétèk
procès: prc, prck
processus: prcçs, prcçsk, prcs, prcsk, prcss, prcssk
procure: prcrri, prcrrj, prcrrsj, prcrrsi
profession: prfn, prfçn
programme: pgrm, prgrm, prgrmri, prgrmrj, prgrmrsj, prgrmrsi, prgmri, prgmrj, prgmrsj, prgmrsi
progression: pgrn, prgrçn, prgrn
progressivité: prgrçvt, pgrçvt
prolonge: prlgri, prlgrj, prlgrsj, prlgrsi, prlri, prlrj, prlrsj, prlrsi
proposition: ppn, ppzn, prpzn
propos: prpo, prpok
protagoniste: prtgnt, prtgnst
puissance: pwçç, pçç
querelle: qry, qrl
racisme: rcsm, rczm
radicalisation: rdczln, rdclzn
rallonge: rlgri, rlgrj, rlgrsj, rlgrsi, rlhg
ramasse: rmçri, rmçrj, rmçrsj, rmçrsi
éloignement: élnm, élym
rayonne: rynri, rynrj, rynrsj, rynrsi
réalisme: rlzm, rlsm
recherche: ràrà, ràràri, ràràrj, ràràrsj, ràràrsi
récidive: rcdv, rcdvri, rcdvrj, rcdvrsj, rcdvrsi
réclame: rclmri, rclmrj, rclmrsi
récompense: rcpsri, rcpsrj, rcpsrsj, rcpsrsi, rcps
recoupe: rcpri, rcprj, rcprsj, rcprsi
recours: rcù, rcùk, rcrrj, rcrrt
récrimination: rcrmnn, rcrmn
redoute: rdtri, rdtrj, rdtrsj, rdtrsi
règle: rg, rglri, rglrj, rglrsj, rglrsi
régule: rglri, rglrj, rglrsi
rejet: rjé, rg
relâche: rlà, rlàri, rlàrj, rlàrsj, rlàrsi
relance: rlri, rlrj, rlrsj, rlrsi, rlcri, rlcrj, rlcrsj, rlcrsi, rlç
relève: rlvri, rlvrj, rlvrsj, rlvrsi, rlri, rlrj, rlrsj, rlrsi
remarque: rmrq, rmrqri, rmrqrj, rmrqrsj, rmrqrsi
rencontre: rctrrj, rctrrsj, rctrrsi, rctrri, rct, rèctri, rèctrj, rèctrsj, rèctrsi
désendettement: dztm, dzdtm
renonce: rncri, rncrj, rncrsj, rncrsi, rnhri, rnhrj, rnhrsj, rnhrsi, rnri, rnrj, rnrsj, rnrsi
renverse: rvrsri, rvrsrj, rvrsrsj, rvrsrsi
repère: rprri, rprrj, rprrsi
reporter: rprtr, rprr
repousse: rpùçri, rpùçrj, rpùçrsj, rpùçrsi
représentativité: rprztvt, rprzttvt
répression: rprçn, rprn
reproche: rprà, rpràri, rpràrj, rpràrsj, rpràrsi
réservation: rzrvn, rzvn
réserve: rzrv, rzrvri, rzrvrj, rzrvrsi, rzrri, rzrrj, rzrrsj, rzrrsi
réservoir: rzvo, rzrvo
responsabilité: rspsblt, rspblt
resserre: rçrri, rçrrj, rçrrsj, rçrrsi
ressort: rçrtri, rço, rsrtri
reste: rstri, rstrj, rstrsj, rstrsi, rst
rétention: rttn, rtèn
réticence: rtcç, rtç
retourne: rtrnri, rtrnrj, rtrnrsj, rtrnrsi
retour: rtùr, rtù
désengagement: dzggm, dzgm
rigole: rglri, rglrj, rglrsi
riposte: rpstri, rpstrj, rpstrsi
risque: rsqri, rsqrj, rsqrsj, rsqrsi, rsq
satisfecit: stsfci, stsfcik
saute: stri, strj, strsj, strsi
sauvegarde: svgrd, svgrdri, svgrdrj, svgrdrsj, svgrdrsi
sauvegardes: svgrdrst, svgrdrt
savoir: ç, svr
secours: scrrj, scrrt
secrétariat: scrtria, scrtra
séjour: sjùr, sjù
séquence: sqç, sqcri, sqcrj, sqcrsj, sqcrsi
serre: srri, srrj, srrsi
signature: sntu, sytu
signe: syri, syrj, syrsj, syrsi
signification: snfcn, syfcn
silhouette: slùt, slt
enseignement: èsnm, èsym
situation: stn, sttn
smille: smyri, smyrj, smyrsi
société: sté, sct
songe: shgri, shgrj, shgrsj, shgrsi, sgri, sgrj, sgrsi
sorte: srt, srtrsj, srtrsi
statisticien: sttstcé, stttcé
statue: sttri, sttrj, sttrsj, sttrsi
structure: strctu, strctrri, strctrrj, strctrrsi, strcu
succès: sxc, sxck
suspicion: sspn, spn
synopsis: snpsi, snpsik
tâche: taà, tà, tàri, tàrj, tàrsi
tape: tpri, tprj, tprsj, tprsi
taux: to, tok
télécommunication: tlcmncn, tlcmn, tlcmcn
télégraphie: tlgrfri, tlgrfrj, tlgrfrsj
téléphone: tlfn, tlfnri, tlfnrj, tlfnrsj, tlfnrsi
temps: tè, tèk
tentative: ttv, tttv
tente: tètri, tètrj, tètrsj, tètrsi, ttri, ttrj, ttrsi
territoire: trto, trrto
terrorisme: trrsm, trrm
toilette: tlt, tltri, tltrj, tltrsj, tltrsi
tombe: thbrj, thbri, thbrsj, thbrsi, tbri, tbrj, tbrsi
touche: tùà, tùàri, tùàrj, tùàrsj, tùàrsi
tourisme: trsm, tùrm
tourne: trnri, trnrj, trnrsj, trnrsi
trace: trç, trri, trrj, trrsi
traîne: trnri, trnrj, trnrsj, trnrsi
tranche: tràri, tràrj, tràrsj, tràrsi, trà
transgression: trsgrn, trsgrçn
traverse: trvrsri, trvrsrj, trvrsrsi
travers: trvr, trvrk
tréfonds: trdrj, trdrt
tribunal: tbl, trbnl
trompe: trprj, trpri, trprsi
tropisme: trpsm, trpm
univers: unvr, unvrk
variation: vrtn, vrn
véhicule: vhcl, vclri, vclrj, vclrsj, vclrsi
veille: vyri, vyrj, vyrsj, vyrsi, vey
velléité: vlt, vlit
version: vrsn, vrn
viole: vlrsi, vlri, vlrj
visite: vzt, vztri, vztrj, vztrsi
vis: vrqj, vvrj, vvrt
vitalité: vtlt, vttl
vit: vrqi, vvri
voie: vrsj, vrsi
voix: vx, vxk
volonté: vlt, vlht
vouloir: w, vlr
voyage: vygri, vygrj, vygrsi, vyg
débordant: dbrè, dbrdè
débutant: dbtè, dbè
décidant: dcè, dcdè
déconcertant: dccrtè, dccrè
décourageant: dcrgè, dcrè
décrédibilisant: dcrblzè, dcrdblzè
décrivant: dcrè, dcrvè
définissant: dfnè, dfnçè
dégageant: dggè, dgè
dégradant: dgrè, dgrdè
demandant: dmdè, dmè
démontant: dmtè, dmhè
démotivant: dmtvè, dmtrè
dénonçant: dnçè, dncè
déplaçant: dplcè, dplè
déployant: dplè, dplyè
déportant: dprè, dprtè
dérangeant: drègè, drgè
dérobant: drè, drbè
déroutant: drctè, drtè
désespérant: dzprè, dzsprè
désignant: dznè, dzyè
desservant: dsrvè, dçrvè
développant: dvlpè, dvlè
devant: dvè, xè
dictant: dctè, dcè
disant: dè, dzè
dirigeant: drgè, drè
documentant: dcmè, dcmtè
échangeant: éàè, éàgè
échappant: éàpè, éàè
écrivant: écrè, écè, écrvè
effaçant: efcè, efè
effrayant: efrè, efryè
élaborant: élbrè, élbè
élargissant: élrgè, élrgçè
élevant: élè, élvè
éloignant: élnè, élyè
élucidant: élcdè, élcè
employant: èplè, èplyè
emportant: èprtè, èprè
encourageant: ècrgè, ècrè
endommageant: èdmgè, èdmè
engendrant: ègdrè, ègdè
enlevant: èlvè, èlè
enregistrant: èrgstè, èrgstrè
enrichissant: èràè, èràçè
enseignant: èsnè, èsyè
entendant: ètdè, ètèdè
entourant: ètùrè, ètrè
entreprenant: ètrprdè, ètrprè
entrant: ètrè, ètè
envisageant: èvzè, èvzgè
envoyant: èvyè, evyè
équipant: éqpè, éqè
escaladant: scldè, sclè
escomptant: sctè, scpè
estimant: stmè, estmè
estompant: stpè, stè
établissant: étblè, étblçè
évitant: évtè, évè
exaltant: xltè, xlè
excédant: xcè, xcdè
excluant: xclè, xcluè
exerçant: xrcè, xrè
exigeant: xgè, xiè
expérimentant: xprmtè, xprmè
explicitant: xplctè, xplcè
exploitant: xplè, xpltè
facilitant: fcltè, fltè
faisant: fè, fzè
fascinant: fsnè, fcnè
félicitant: flctè, flcè
figurant: fgrè, fgè
finançant: fncè, fnè
finissant: fnè, fnçè
flattant: fltè, flè
foisonnant: fwznè, fznè
fondant: fhdè, fdè
fournissant: frnè, fnè
franchissant: fràè, fràçè, fàè
frappant: frpè, frè
frustrant: frstè, frstrè
gagnant: gnè, gyè
garantissant: grtçè, grtè
gardant: grdè, grè
habilitant: ablè, abltè
habitant: abtè, abè
hébergeant: ébrè, ébrgè
ignorant: iyè, iyrè
illustrant: ilstrè, ilstè
impressionnant: éprçnè, éprnçè
imputant: épè, éptè
induisant: édzè, édè
inscrivant: éscrè, éscrvè
insistant: éssè, ésstè
intéressant: étrçè, étçè
interrogeant: étrgè, étrè
introduisant: étrdè, étrdwè, étrdzè, étrdrè
inventant: évtè, évè
joignant: jdè, jwdè
jouant: jùè, jè
jouissant: jùè, jwçè, jwè
jugeant: jgè, jè
lançant: lècè, lcè
levant: lè, lvè
limitant: lmtè, lmè
luisant: lzè, lwè
mangeant: mègè, mgè
manifestant: mnfstè, mnfsè
médisant: mdzè, mdè
menaçant: mnè, mnçè, mncè
ménageant: mnè, mngè
méritant: mrè, mrtè
militant: mltè, mlè
motivant: mtvè, mtè
naissant: nçè, ntè
nécessitant: ncçè, ncçtè
négligeant: nglgè, nglè
observant: obsrvè, obsrè
obtempérant: obtpè, obtprè
obtenant: obtnè, otnè
occupant: ocpè, ocè
orientant: orè, ortè
participant: prtcè, prtcpè
penchant: pèàè, pàè
pensant: pèsè, psè
permettant: prmtè, prtmè
plaçant: plè, plcè
plaignant: plyè, pldè
plaisant: plè, plzè
poignardant: pyrè, pyrdè
portant: prè, prtè
pouvant: pvè, pè
précédant: prcdè, prcè
précipitant: prcpè, prcptè
prémunissant: prmnè, prmnçè
prenant: prdè, prnè
préparant: prprè, prpè
présentant: prztè, przè
préservant: przrvè, pzrvè, przrè
présidant: przè, przdè
prévoyant: prvè, prvyè
privant: prè, prvè
produisant: prdè, prdzè
profitant: prftè, prfè
programmant: prgrmè, prgmè
progressant: prgrçè, pgrçè
prohibant: prbè, prè
prolongeant: prlgè, prlè
prononçant: prncè, prnè
prospérant: prspè, prsprè
protégeant: prtgè, prtè
protestant: prtstè, prtsè
racontant: rchè, rchtè
rajoutant: rjtè, rjùè
ralentissant: rltè, rltçè
rapportant: rprtè, rprè
recommandant: rcmdè, rcmè
reconduisant: rcdwè, rcdè
reconnaissant: rcntè, rcnçè
rédigeant: rdè, rdgè
refaisant: rfè, rè
réfléchissant: rflàè, rflàçè
regardant: rgrdè, rgrè
régissant: rgçè, rgè
réglementant: rglmtè, rglmè
regrettant: rgrtè, rgrè
regroupant: rgrpè, rgrè
réintroduisant: rtrdzè, rtrdè
rejoignant: rjdè, rjyè
réjouissant: rjè, rjwè
relançant: rlè, rlcè
relevant: rlvè, rlè
remémorant: rmmè, rmmrè
remerciant: rmrcè, rmcè
remontant: rmtè, rmè
remplaçant: rplcè, rèplè, rplè, rplçè
rencontrant: rctrè, rèctè
rendormant: rdrmè, rdmè
rendant: rèdè, rdè
renforçant: rfrcè, rfrè, rfrçè
renonçant: rncè, rnhè, rnè
rénovant: rnè, rnvè
renseignant: rsyè, rèsyè
rentrant: rtrè, rètè
reparlant: rprlè, rplè
répétant: rpè, rptè
reportant: rprtè, rprè
reprenant: rprdè, rprnè
représentant: rprztè, rprzè
reproduisant: rprdè, rprdzè
réservant: rzrvè, rzrè
résorbant: rzbè, rzrbè
respectant: rspctè, rspcè
ressortant: rçrtè, rsrtè
ressurgissant: rçrgè, rsrgè
rétablissant: rtblè, rtblçè
retardant: rtrdè, rtrè
retentissant: rttçè, rttè
retrouvant: rtrvè, rtrè
réunissant: runè, rnè, rnçè
saisissant: szè, szçè
satisfaisant: stsfzè, stsfè
sachant: çè, sàè, svè
sévissant: svçè, svè
signifiant: snfè, syfè
sollicitant: slcè, slctè
songeant: shgè, sgè
soulageant: slè, slgè
soulignant: slnè, slyè
après-demain: admé, aprdmé
subissant: sbçè, sbè
substituant: sbstè, sbsttè
suffisant: sfè, sfzè
suivant: swvè, svè, swè
surplombant: srplè, srplbè
surprenant: srprdè, srprnè, sprdè, sprnè
suscitant: sctè, scè
systématisant: sstmtzè, sstmzè
tardant: trdè, tdè, trè
tentant: tètè, ttè
tombant: thbè, tbè
traduisant: trdè, trdwè, trdzè
traitant: trtè, trè
transcendant: trcè, trcdè
transitant: trzè, trztè
unissant: unçè, unè
validant: vlè, vldè
vendant: vèdè, vdè
voyant: vè, vyè
voulant: wè, vlè
abordé: abrd, abrdé
abrégé: abrg, abrgé
absorbé: absrbé, absrb, absré
arrangé: argé, arèg, arèé
assis: açi, açws
assermenté: açrmt, açrmté
assisté: açst, açsé, açsté, açté
assoupli: açpli, açpi
attardé: atrdé, atrd, atré
atteint: até, atdri
augmenté: ogmté, ogmé, ogmt
auguré: ogé, ogré
automatisé: otmtzé, otmzé
avancé: avcé, avc, avé
balancé: blc, blé
biseauté: bzt, bzé
bridé: brd, bré
cantonné: ctné, cètné
chargé: àrg, àré
circonscrit: crcscri, crcsct
collecté: clcté, clct, clcé
commenté: cmèt, cmèé
commis: cmtrqj, cmts, cmi
complété: cplté, cplt, cplé
compris: cprdrqj, cprds, cpri
compromis: cprmi, cprmtrqj, cprmts
concentré: cctré, ccté
concerté: ccrt, ccrté
condamné: chdné, cdné
conduit: cdwri, cdwt
configuré: cfgé, cfgré
connu: cntu, cnu
connecté: cncté, cnct, cncé
conquis: cqrrqj, cqrs
conservé: csrvé, chsrvé
consolidé: csld, csldé
constaté: cstt, csté, cstté
construit: cstrri, cstrt
consulté: cslé, cslt, cslté
contacté: ctcté, ctcé, ctct
contenté: ctné, chtté, ctté
contesté: ctsté, ctst, ctsé
continué: ctné, chtné
contraint: ctrdri, ctrdt, ctré
contrasté: ctrst, ctrsé
contrebalancé: ctrblc, ctrblé
contrefait: ctrfri, ctrft
correspondu: crspdu, crdu
corrigé: crg, cré, crgé
couvert: cvrt, cvr
craint: crdri, crdt
cru: cru, èu
cultivé: cltv, clté
débilité: dblé, dblt
débité: dbt, dbé
débordé: dbrd, dbré, dbrdé
débouté: dbt, dbùt
débuté: dbt, dbté, dbé
décidé: dcd, dcé, dcdé
déconcerté: dccrt, dccré
déconnecté: dcncté, dcnct
découragé: dcrgé, dcrg, dcré
décrédibilisé: dcrblzé, dcrdblzé
décrété: dcrt, dcré
décrit: dcrri, dcrt
défailli: dfyrqi, dfyi
défait: dfri, dft
dégagé: dggé, dgg, dgé
dégradé: dgrd, dgré, dgrdé
déjanté: djt, djé
demandé: dmdé, dmé, dmd
démonté: dmté, dmht, dmhé
démotivé: dmtvé, dmtré
dénoncé: dnçé, dncé
déplacé: dplcé, dplc, dplé
déployé: dplé, dplyé
déporté: dprt, dpré, dprté
député: dpt, dpé
dérangé: drègé, drgé, drg
dérobé: drb, dré, drbé
dérouté: drcté, drté
désespéré: dzpré, dzspré
désigné: dzné, dzyé
desservi: dsrvi, dçrvi
développé: dvlpé, dvlé, dvlp
dévisagé: dvzg, dvzé
dé: dvé, xé
dicté: dcté, dct, dcé
diligenté: dlgt, dlgé
dit: dri, drqi, dt
dirigé: drgé, drg, dré
disparu: dspru, dsprtu
dissipé: dçp, dçé
distrait: dstrri, dstrt, dstré
documenté: dcmt, dcmé, dcmté
échangé: éàg, éàé, éàgé
échappé: éàpé, éàp, éàé
écrit: écrt, écrri, écri, éct
effacé: efcé, efc, efé
efforcé: efrcé, efrc, efré
effrayé: efré, efryé
éjecté: éjct, éjcé
élaboré: élbré, élbé
élevé: élv, élé, élvé
éloigné: élné, élyé
élucidé: élcdé, élcd, élcé
emberlificoté: èbrlfct, èbrlfcé
employé: èplé, èplyé
emporté: èprté, èprt, èpré
enclavé: èclv, èclé
encouragé: ècrgé, ècrg, ècré
endetté: edt, edé
endommagé: èdmgé, èdmg, èdmé
enfreint: èfrdri, èfrdt
engagé: èggé, ègg
engendré: ègdré, ègdé
engorgé: ègrgé, ègrg
enjoint: èjdri, èjdt
enlevé: èlvé, èlv, èlé
enregistré: èrgsté, èrgstré
enseigné: èsné, èsyé
entendu: ètèdu, ètdu
entouré: ètùré, ètré
entravé: ètrvé, ètrv
entrelacé: ètrlc, ètrlé
entrepris: ètrpri, ètrprds, ètrprrqj, ètrprs
entré: ètré, èté
envisagé: èvzg, èvzé, èvzgé
envoyé: èvyé, evyé
équipé: éqpé, éqp, éqé
escaladé: scldé, scld, sclé
escompté: scté, scpt, scpé, sct
estimé: stmé, estmé
estompé: stpé, stp, sté
éteint: étdri, étdt
étreint: étrdt, étrdri
évité: évté, évt, évé
exacerbé: xcrb, xcré
exalté: xlté, xlt, xlé
exaucé: xoc, xoé
excédé: xcd, xcé, xcdé
excepté: xcpt, xcpé
exercé: xrcé, xrc, xré
exigé: xgé, xig, xié, xg
expérimenté: xprmté, xprmt, xprmé
explicité: xplcté, xplct, xplcé
exploité: xplt, xplé, xplté
extradé: xtrd, xtré
extrait: xtrri, xtrt
facilité: fclté, fclt, flté
fait: fé, fi, ft
fallu: flu, uu
félicité: flcté, flcé, flct
figuré: fgré, fgé
financé: fncé, fnc, fné
flatté: flté, flt, flé
fondé: fhdé, fhd
fourni: frni, fni
fragmenté: frgmt, frgmé
franchi: frài, fài
frappé: frpé, frp, fré
frelaté: frlt, frlé
frustré: frsté, frstré
gardé: grdé, gré, grd
gravité: grvt, grvé
habilité: ablt, ablé, ablté
habité: abté, abt, abé
hébergé: ébrg, ébré, ébrgé
hérité: ért, éré
ignoré: iyé, iyré
illustré: ilstré, ilsté
implanté: éplt, éplé
impressionné: éprçné, éprnçé
imputé: épt, épé, épté
inclus: éclrj, éclrt, écls
induit: édri, édt
inscrit: éscrt, éscrri, éscri
insisté: ésst, éssé, éssté
inspecté: éspct, éspcé
interconnecté: étrcnct, étrcncé
interdit: étrdri, étrdrqi, étrdt, étrdi
intéressé: étrçé, étçé
interrogé: étrgé, étrg, étré
introduit: étrdt, étrdri, étrdwri, étrdwt, étrdrri, étrdrt
inventé: évté, évt, évé
invité: évté, évt
joint: jdt, jdri, jwdri, jwdt
joué: jùé, jé
joui: jùi, jwi
jugé: jgé, jg, jé
lancé: lècé, lcé
levé: lv, lé, lvé
limité: lmté, lmt, lmé
liquidé: lqd, lqé
mangé: mègé, mgé
manifesté: mnfsté, mnfst, mnfsé
marché: mràé, mré
maudit: mdri, mdrqi, mdt
méconnu: mcntu, mcnu
médit: mdri, mdt
mélangé: mlg, mlgé
menacé: mnc, mné, mnçé, mncé
ménagé: mng, mné, mngé
mérité: mrt, mré, mrté
mis: mtrqj, mts
milité: mlté, mlt, mlé
mitigé: mtg, mté
motivé: mtv, mtvé, mté
mouvementé: mvmt, mvmé
naufragé: nfrg, nfré
nécessité: ncçt, ncçé, ncçté
négligé: nglgé, nglg, nglé
numéroté: nmrt, nmré
obligé: oblgé, oblg
obsédé: obsd, obsé
observé: obsrvé, obsrv, obsré
obtempéré: obtpé, obtpré
obtenu: obtnu, otnu
occulté: oclt, oclé
occupé: ocpé, ocp
orienté: oré, ort, orté
ouvert: ùvr, ùvrt
parfait: prfé, prfri, prft
participé: prtcp, prtcé, prtcpé
pensé: pèsé, psé
permis: prmtrqj, prmts, prmi, prtms
persécuté: prsct, prscé
persuadé: prsdé, prsd
phagocyté: fgct, fgcé
placé: plc, plé, plcé
plaint: pldri, pldt
poignardé: pyrd, pyré, pyrdé
pointé: pwt, pwé
porté: prt, pré, prté
précédé: prcdé, prcd, prcé
précipité: prcpt, prcpé, prcpté
prédit: prdri, prdt
prélevé: prlv, prlé
préoccupé: prcpé, prcp
préparé: prpré, prpé
présenté: przté, przt, przé
préservé: przrvé, pzrvé, przrv, przré
présidé: przé, przd, przdé
privé: prv, pré, prvé
procédé: prcd, prcdé
produit: prdi, prdri, prdt
profité: prfté, prft, prfé
programmé: prgrmé, prgmé
progressé: prgrçé, pgrçé
prohibé: prbé, prb, pré
prolongé: prlgé, prlg, prlé
prononcé: prncé, prnc, prné
prorogé: prrg, prré
prospecté: prspct, prspcé
prospéré: prspé, prspré
protégé: prtgé, prtg, prté
protesté: prtsté, prtst, prtsé
raconté: rcht, rché, rchté
rajouté: rjté, rjùt, rjùé
rapporté: rprté, rprt, rpré
réaménagé: rmng, rmné
reçu: rcvu, rçu
recommandé: rcmdé, rcmd, rcmé
reconduit: rcdwri, rcdwt, rcdri, rcdt
reconnu: rcntu, rcnu
recruté: rcrté, rcrt
rédigé: rdg, rdé, rdgé
redit: rdri, rdt
réduit: rdwri, rdwt
refait: rfri, rft, rri, rt
regardé: rgrdé, rgrd, rgré
réglementé: rglmté, rglmt, rglmé
regretté: rgrté, rgrt, rgré
regroupé: rgrpé, rgrp, rgré
réintroduit: rtrdri, rtrdt
rejeté: rjt, rjé
rejoint: rjdri, rjdt
réjoui: rji, rjwi
relancé: rlc, rlé, rlcé
relevé: rlvé, rlv, rlé
remémoré: rmmé, rmmré
remercié: rmrcé, rmcé
remis: rmtrqj, rmts, rmi
remonté: rmté, rmt, rmé
remplacé: rplcé, rèplc, rèplé, rplc, rplé, rplçé
rencontré: rctré, rècté
rendormi: rdrmi, rdmi
rendu: rèdu, rdu
renforcé: rfrcé, rfrc, rfré, rfrçé
renoncé: rncé, rnhc, rnhé, rnc, rné
rénové: rnv, rné, rnvé
renseigné: rsyé, rèsyé
rentrait: rtrrii, rètrii
rentré: rtré, rèté
reparlé: rprlé, rplé
répercuté: rprcté, rprct
répété: rpt, rpé, rpté
replacé: rèplc, rèplé
reporté: rprté, rprt, rpré
repris: rprdrqj, rprds, rpri
représenté: rprzté, rprzt, rprzé
reproduit: rprdri, rprdt
requis: rqi, rqrs
réservé: rzrvé, rzrv, rzré
résorbé: rzbé, rzrbé, rzrb
résolu: rzdu, rzlu
respecté: rspcté, rspct, rspcé
ressorti: rçrti, rsrti
ressurgi: rçrgi, rsrgi
restreint: rstré, rstdri, rstdt
retardé: rtrdé, rtrd, rtré
retraité: rtrt, rtré
retransmis: rtrsmtrqj, rtrsmts
retrouvé: rtrvé, rtré, rtrv
réuni: runi, rni
satisfait: stsfri, stsft, stsfé
sauvegardé: svgrdé, svgrd
su: çu, svu
séquencé: sqcé, sqc
signifié: snfé, syfé
sollicité: slct, slcé, slcté
songé: shgé, sgé
soulagé: slg, slé, slgé
souligné: slné, slyé
soumis: smtrqj, smts, smi
souscrit: sscrri, sscrt
soustrait: sstrri, sstrt
au-delà: odlà, odla
substitué: sbsté, sbstté
suivi: swvi, svi, swi
surplombé: srplb, srplé, srplbé
surpris: srpri, srprik, srprdrqj, srprds, sprdrqj, sprds
suscité: scté, sct, scé
systématisé: sstmzé, sstmtzé
tardé: trdé, tdé, trd, tré
tenté: tèté, tté
tombé: thbé, tbé
tracé: trc, tré
traduit: trdri, trdt, trdwri, trdwt
traité: trté, trt, tré
transcendé: trcd, trcé, trcdé
transité: trzt, trzé, trzté
transmis: trsmtrqj, trsmts, trsmi
transporté: trsprt, trsprté
accepté: axpté, axpt, axpé
accompagné: acpné, acpyé
accordé: acrdé, acrd, acré
accrédité: acrdté, acrdt, acrdé
accru: acrtu, acru
acheté: aàté, aàt
achevé: aàvé, aàv, aàé
achoppé: aàp, aàé
acquis: aqi, aqrs
acquitté: aqt, aqé, aqté
adapté: adpt, adpé, adté
admis: admtrqj, admts
adopté: adté, adt, adpt, adpé, adpté
affecté: afcté, afct
affronté: afrté, afrht, afrhé
aggravé: agrvé, agrv, agré
agité: agté, agt, agé
agrémenté: agrmt, agrmé
ajouté: ajté, ajt, ajé
ajusté: ajsté, ajst, ajsé
allongé: alg, alé, algé
amélioré: amlré, amlé
aménagé: amng, amné
amorcé: amrc, amré, amrcé
annoncé: ancé, anhc, anhé, anc, ançé
annoté: ant, ané
anticipé: ètcpé, ètcp, ètcé
apparu: aprtu, apru
apporté: aprté, aprt
apprécié: aprcé, aprcié
appréhendé: aprèd, aprèé, aprd, apré, aprdé
appris: aprdrqj, aprds, apri
approprié: aprpré, aprpé
approuvé: aprvé, aprv, apré
argumenté: argmt, argmé
validé: vld, vlé, vldé
vanté: vèt, vèé
vendu: vèdu, vdu
voulu: wu, vlu
extraordinairement: xtrrdnrm, xtrdnrm
cantonner: ctnr, cètnr
décider: dcr, dcdr
décourager: dcrgr, dcrr
échanger: éàr, éàgr
échapper: éàpr, éàr
écrire: écrr, écr
effacer: efcr, efr
efforcer: efrcr, efrr
effrayer: efrr, efryr
élaborer: élbrr, élbr
élever: élr, élvr
éloigner: élnr, élyr
élucider: élcdr, élcr
employer: èplr, èplyr
emporter: èprtr, èprr
encourager: ècrgr, ècrr
endommager: èdmgr, èdmr
engendrer: ègdrr, ègdr
menacer: mnr, mnçr, mncr
mériter: mrr, mrtr
militer: mltr, mlr
motiver: mtr, mtvr
nécessiter: ncçr, ncçtr
négliger: nglgr, nglr
observer: obsrvr, obsrr
obtempérer: obtpr, obtprr
obtenir: obtnr, obtenir, otnr
occuper: ocpr, ocr
orienter: orr, ortr
dégager: dggr, dgr
dégoûter: dfntr, dgtr
dégrader: dgrr, dgrdr
demander: dmdr, dmr
démonter: dmtr, dmhr
démotiver: dmtvr, dmtrv
dénoncer: dnçr, dncr
déplacer: dplcr, dplr
déployer: dplr, dplyr
déporter: dprr, dprtr
déranger: drègr, drgr
dérober: drr, drbr
dérouter: drcto, drtr
desservir: dsrvr, dçrvr
développer: dvlpr, dvlr
dicter: dctr, dcr
diriger: drgr, drr
documenter: dcmr, dcmtr
enlever: èlvr, èlr
enregistrer: èrgstr, èrgstrr
enseigner: èsnr, èsyr
entendre: ètdr, ètèdr
entourer: ètùrr, ètrr
entreprendre: ètrprdr, ètrprd
entrer: ètrr, ètr
envoyer: èvyr, evyr
épargner: épyr, épryr
équiper: éqpr, éqr
escalader: scldr, sclr
escompter: sctr, scpr
estimer: stmr, estmr
estomper: stpr, str
éviter: évtr, évr
exalter: xltr, xlr
excéder: xcr, xcdr
exercer: xrcr, xrr
exiger: xgr, xir
expérimenter: xprmtr, xprmr
expliciter: xplctr, xplcr
exploiter: xplr, xpltr
faciliter: fcltr, fltr
féliciter: flctr, flcr
figurer: fgrr, fgr
financer: fncr, fnr
flatter: fltr, flr
fournir: frnr, fnr
franchir: fràr, fàr
frapper: frpr, frr
frustrer: frstr, frstrr
garder: grdr, grr
habiliter: ablr, abltr
habiter: abtr, abr
héberger: ébrr, ébrgr
ignorer: iyr, iyrr
illustrer: ilstrr, ilstr
impressionner: éprçnr, éprnçr
imputer: épr, éptr
insister: éssr, ésstr
intéresser: étrçr, étçr
interroger: étrgr, étrr
introduire: étrdr, étrdwr, étrdrr
inventer: évtr, évr
joindre: jdr, jwdr
jouer: jùr, jr
jouir: jùr, jwr
juger: jgr, jr
limiter: lmtr, lmr
manifester: mnfstr, mnfsr
participer: prtcr, prtcpr
permettre: prmtr, prtmr
poignarder: pyrr, pyrdr
précéder: prcdr, prcr
précipiter: prcpr, prcptr
préparer: prprr, prpr
priver: prr, prvr
profiter: prftr, prfr
programmer: prgrmr, prgmr
progresser: prgrçr, pgrçr
prohiber: prbr, prr
prolonger: prlgr, prlr
prononcer: prncr, prnr
prospérer: prspr, prsprr
protéger: prtgr, prtr
protester: prtstr, prtsr
raconter: rchr, rchtr
rajouter: rjtr, rjùr
rapporter: rprtr, rprr
recommander: rcmdr, rcmr
reconduire: rcdwr, rcdr
rédiger: rdr, rdgr
refaire: rfr, rf
regarder: rgrdr, rgrr
réglementer: rglmtr, rglmr
regretter: rgrtr, rgrr
regrouper: rgrpr, rgrr
réjouir: rjr, rjwr
relancer: rlr, rlcr
relever: rlvr, rlr
remémorer: rmmr, rmmrr
remercier: rmrcr, rmcr
remonter: rmtr, rmr
remplacer: rplcr, rèplr, rplr, rplçr
rencontrer: rctrr, rèctr
rendormir: rdrmr, rdmr
rendre: rèdr, rdr
renforcer: rfrcr, rfrr, rfrçr
renoncer: rncr, rnhr, rnr
rénover: rnr, rnvr
renseigner: rsyr, rèsyr
rentrer: rtrr, rètr
reparler: rprlr, rplr
répéter: rpr, rptr
reprendre: rprdr, rprdr
respecter: rspctr, rspcr
ressortir: rçrtr, rsrtr
ressurgir: rçrgr, rsrgr
retarder: rtrdr, rtrr
retrouver: rtrvr, rtrr
réunir: runr, rnr
signifier: snfr, syfr
solliciter: slcr, slctr
songer: shgr, sgr
soulager: slr, slgr
souligner: slnr, slyr
substituer: sbstr, sbsttr
suivre: swvr, svr, swr
surplomber: srplr, srplbr
surprendre: srprdr, sprdr
susciter: sctr, scr
tarder: trdr, tdr, trr
tenter: tètr, ttr
tomber: thbr, tbr
traduire: trdr, trdwr
traiter: trtr, trr
transcender: trcr, trcdr
transiter: trzr, trztr
transmettre: trsmtr, trsmtr
valider: vlr, vldr
vendre: vèdr, vdr
présenter: prztr, przr
préserver: przrvr, pzrvr, przrr
présider: przr, przdr
représenter: rprztr, rprzr
réserver: rzrvr, rzrr
résorber: rzbr, rzrbr
résoudre: rzdr, rzdr
fonctionnement: fctnm, fcnm
franchissement: fràçm, frçm
incontestablement: éctstblm, éctsblm
incroyablement: écrblm, écryblm
indubitablement: édbtblm, édbtlm
lancement: lècm, lcm
majoritairement: mjrtrm, mjrtm
mécontentement: mcttm, mctm
mentalement: mètlm, mtlm
mollement: mlm, molm
moment: mom, mmè
particulièrement: prtclrm, prctlrm
postérieurement: pstrrm, pstrm
potentiellement: pttlm, ptlm
réellement: rélm, rllm
renseignement: rsnm, rsym
sincèrement: sécrm, scrm
préventivement: prvtvm, prvtm
prioritairement: prrtrm, prtrm
purement: purm, prm
quantitativement: qttvm, qtttvm
rapidement: rpdm, rpmd
soulagement: slgm, sùlgm
souplement: splm, sùplm
splendidement: splm, spldm
statutairement: stttrm, sttrm
substantiellement: sbstlm, sbsttlm
sûrement: surm, srm
positionnement: pznm, pztnm
théoriquement: trqm, torqm
ultérieurement: ultrrm, ultrm
vagissement: vgçm, vçgm
assister: açsr, açstr, açtr
attarder: atrdr, atrr
augmenter: ogmtr, ogmr
augurer: ogr, ogrr
avancer: avcr, avr
décrédibiliser: dcrblzr, dcrdblzr
envisager: èvzr, èvzgr
systématiser: sstmtzr, sstmzr
désespérer: dzprr, dzsprr
désigner: dznr, dzyr
collecter: clctr, clcr
compléter: cpltr, cplr
concentrer: cctrr, cctr
condamner: chdnr, cdnr
configurer: cfgr, cfgrr
connecter: cnctr, cncr
conserver: csrvr, chsrvr
constater: cstr, csttr
consulter: cslr, csltr
contacter: ctctr, ctcr
contenter: ctnr, chttr, cttr
contester: ctstr, ctsr
continuer: ctnr, chtnr
correspondre: crspdr, crdr
corriger: crr, crgr
croire: crr, è
déborder: dbrr, dbrdr
débuter: dbtr, dbr
absorber: absrbr, absrr
accepter: axptr, axpr
accompagner: acpnr, acpyr
accorder: acrdr, acrr
accréditer: acrdtr, acrdr
achever: aàvr, aàr
acquitter: aqr, aqtr
adapter: adpr, adtr
adopter: adtr, adpr, adptr
affronter: afrtr, afrhr
aggraver: agrvr, agrr
agiter: agtr, agr
ajouter: ajtr, ajr
ajuster: ajstr, ajsr
allonger: alr, algr
améliorer: amlrr, amlr
amorcer: amrr, amrcr
annoncer: ancr, anhr, ançr
anticiper: ètcpr, ètcr
apprécier: aprcr, aprcir
appréhender: aprèr, aprr, aprdr
approprier: aprprr, aprpr
approuver: aprvr, aprr
arranger: argr, arèr
pour: pùr, pù
porte-à-faux: prtfx, pàf
sous-traitance: strtç, sùtrtç
ensuite: èst, èswt
ainsi: ési, éçi
perspective: prspctfy, prspctv
mis à jour: maj, majk
pourtant: pùrtè, prtè
à cet égard: àce, ace
pays-tiers: pt, ptk
ceux: cx, cxy, cxw, cxk
intergouvernemental: étrgvrnml, étrgvrnmtl
très: r, ry, rw, rk
néanmoins: nmç, nnmç
Finlande: fi, féld
emploi du temps: edt, èdtè
volontiers: vltr, vlté
volontariste: vltrt, vltrst
depuis: dpw, dpi
renégociation: rngn, rngcn
inapproprié: éprpré, inprpré
Irlande: irl, ir
est-ce: esc, sc
surprise: srpriy, srprdsy, sprdsy
joignable: jnb, jyb
directive: div, drctfy
entre: ètrri, ètrrj, ètrrsj, ètrrsi, ètr, ètri, ètrj, ètrsi
Copenhague: cphg, cpng
d'aventure: davtu, dvtu
importe: éprtri, éprtrj, éprtrsj, éprtrsi, éprt
paramétrage: prmtrg, prmtrgk
interopérabilité: étrpblt, étrprblt
catastrophisme: ctstrfsm, ctstrfm
maximum: mxmm, mxm
mis en œuvre: meo, meok
confidentialité: cfdtlt, cfdlt
sus-visé: svzé, svzék
géostratégique: gstrgq, gstrtgq
en-deça: èdçà, èdça
cybercriminalité: cbrcrmnlt, cbrcrmntl
interinstitutionnel: étrstttnl, étrsttnl
salafiste: slft, slfst
extraterritorial: xtrtrtrl, xtrtrl
cybersécurité: cbscrt, cbrscrt
réappropriation: rprprn, rpprn
Barcelone: brcln, brclny, brclnw
Thomas de Maizière: tsdme, tsme
tableau de bord: tbd, tdb
accidentogène: axdtgn, acdtgn
permis à points: pàpç, papw
surreprésentation: srprztn, srrprztn
fongibilité: fgblt, fgbltk
accidentologues: axdtlgk, axdtlg
